border_size=1
usage=map

Ww          , Ww          , Wo          , Ww          , Wo          , Wo          , Wo          , Wo          , Wo          , Wo          , Wo          , Wo          , Wo          , Wo          , Wo          , Wo          , Wo          , Wo          , Wo          , Wo          , Ww          , Wo          
Wo          , Ww          , Ce          , Ce          , Ds          , Ww^Vm       , Wo          , Wo          , Wo          , Wo          , Wo          , Wo          , Wo          , Wo          , Wo          , Wo          , Wo          , Wo          , Wo          , Ww          , Ds          , Wo          
Wo          , Dd          , Ce          , 2 Ke        , Ce          , Ww          , Wo          , Wo          , Wo          , Wo          , Wwr         , Wo          , Wo          , Wo          , Wo          , Wo          , Wo          , Wo          , Ww          , Ds          , Ds          , Wo          
Wo          , Ds          , Ss          , Ww          , Ww          , Ww          , Wo          , Wo          , Wo          , Wo          , Wo          , Wo          , Wo          , Wo          , Wo          , Wo          , Wo          , Wo          , Wo          , Ww          , Ww          , Wo          
Wo          , Ww^Vm       , Wo          , Wo          , Wo          , Ww          , Wo          , Wo          , Wo          , Wo          , Wo          , Wo          , Wo          , Wo          , Wo          , Wo          , Wo          , Wo          , Wo          , Wo          , Wo          , Wo          
Wo          , Wo          , Wo          , Wo          , Wo          , Wo          , Wo          , Wo          , Wo          , Wo          , Ww          , Wo          , Wo          , Wo          , Wwf         , Wwf         , Wwf         , Wo          , Wo          , Wo          , Wo          , Wo          
Wo          , Wo          , Wo          , Wo          , Wo          , Wo          , Wo          , Wo          , Wo          , Ww          , Wwf         , Wwf         , Wo          , Wo          , Wo          , Ww          , Ww          , Wo          , Ww^Vm       , Wo          , Wo          , Wo          
Wo          , Wo          , Wo          , Wo          , Wwf         , Wwf         , Ww          , Wo          , Wo          , Wo          , Wo          , Wo          , Wo          , Wo          , Wo          , Wo          , Wwr         , Ww          , Wo          , Ww          , Wo          , Wo          
Wo          , Wo          , Wo          , Wo          , Ww          , Ww          , Wo          , Wo          , Wwr         , Ss          , Chw         , Wo          , Wwf         , Ww^Vm       , Ww          , Wo          , Wo          , Wo          , Wo          , Wo          , Wo          , Wo          
Wo          , Ww          , Wo          , Wo          , Wo          , Ww^Vm       , Wo          , Wo          , Ww          , Chw         , Ds          , Wwf         , Wwf         , Ds          , Ww          , Wo          , Ww^Vm       , Wo          , Wo          , Wwf         , Wwf         , Wo          
Wo          , Wo          , Wwr         , Wo          , Wo          , Wo          , Wo          , Wwf         , Ww          , Ww          , Ss          , Ds          , Chw         , Ss          , Ww          , Ds          , Wwf         , Wo          , Wo          , Wo          , Wo          , Wo          
Wo          , Wo          , Wo          , Wo          , Ww          , Wo          , Wo          , Ww^Vm       , Wwf         , Ss          , Wwf         , Chw         , 1 Khw       , Ss          , Ds          , Chw         , Wo          , Wwf         , Ww          , Wo          , Wo          , Wo          
Wo          , Wo          , Wo          , Ww          , Ww          , Wo          , Wwf         , Ds          , Ds          , Ww          , Ww          , Chw         , Chw         , Ds          , Wwf         , Chw         , Ss          , Wo          , Wo          , Wo          , Wwr         , Wo          
Wo          , Wo          , Wo          , Wo          , Wwf         , Ww          , Wo          , Ww          , Ds          , Wwf         , Ds          , Ss          , Ss          , Ss          , Ww          , Wwf         , Ww          , Wo          , Ww          , Wo          , Wo          , Wo          
Wo          , Wo          , Wo          , Wo          , Wwf         , Wo          , Wo          , Ww^Vm       , Ww          , Chw         , Chw         , Ww          , Ds          , Ds          , Ww^Vm       , Wo          , Wo          , Ww          , Wo          , Wo          , Wo          , Wo          
Wo          , Wo          , Wo          , Wo          , Wo          , Ww^Vm       , Wo          , Ww          , Wwf         , Ss          , Wwf         , Ww          , Wo          , Ds          , Ww          , Wwr         , Wo          , Wo          , Wo          , Wo          , Wo          , Wo          
Wo          , Wo          , Wo          , Wo          , Wo          , Wo          , Wo          , Wo          , Wo          , Ww          , Wo          , Wo          , Wo          , Wo          , Ww          , Ww          , Ww          , Ww          , Wo          , Wo          , Wo          , Wo          
Wo          , Wo          , Wo          , Wo          , Wo          , Wo          , Wo          , Wo          , Wo          , Wo          , Wo          , Ww^Vm       , Wo          , Wwf         , Wo          , Wo          , Wo          , Wo          , Wo          , Wo          , Wo          , Wo          
Wo          , Wwr         , Wo          , Wo          , Wo          , Wo          , Ww          , Wo          , Wo          , Wo          , Wo          , Wo          , Wo          , Wo          , Wo          , Wo          , Wo          , Wo          , Wo          , Ww          , Wo          , Wo          
Wo          , Wo          , Wo          , Wo          , Wo          , Wwf         , Ww          , Ww          , Wwf         , Wo          , Wo          , Wo          , Wo          , Wo          , Wo          , Wo          , Wo          , Wo          , Wo          , Wo          , Wo          , Wo          
Wo          , Wo          , Wo          , Wo          , Wo          , Wo          , Wo          , Wo          , Wo          , Wo          , Wo          , Wo          , Wo          , Wo          , Wo          , Wo          , Wo          , Wo          , Ww          , Ww          , Ww^Vm       , Wo          
Wo          , Wo          , Wo          , Wo          , Wo          , Wo          , Wo          , Wo          , Wo          , Wo          , Wo          , Wo          , Wo          , Wo          , Wo          , Wwr         , Ww^Vm       , Ww          , Dd^Do       , Ce          , Ce          , Ww          
Wo          , Wo          , Wo          , Wo          , Wo          , Wo          , Wo          , Wo          , Wo          , Wo          , Wo          , Wo          , Wo          , Wo          , Wo          , Wo          , Ww          , Dd          , Ce          , 3 Ke        , Dd          , Ww          
Wo          , Wo          , Wo          , Wo          , Wo          , Wo          , Wo          , Wo          , Wo          , Wo          , Wo          , Wo          , Wo          , Wo          , Wo          , Wo          , Wo          , Ww          , Wo          , Ce          , Ww          , Ww          
