border_size=1
usage=map

Wo          , Wo          , Wo          , Wo          , Wo          , Wo          , Wo          , Wo          , Wo          , Wo          , Wo          , Wo          , Wo          , Wo          , Wo          , Wo          , Wo          , Wo          , Wo          , Wo          , Wo          , Wo          , Wo          , Wo          , Wo          , Wo          , Wo          
Wo          , Wo          , Wo          , Wo          , Wo          , Wo          , Wo          , Wo          , Wo          , Wo          , Wo          , Wo          , Wo          , Wo          , Wo          , Wo          , Wo          , Wo          , Wo          , Wo          , Wo          , Wo          , Wo          , Wo          , Wo          , Wo          , Wo          
Wo          , Wo          , Wo          , Wo          , Wo          , Wo          , Wo          , Wo          , Wo          , Wo          , Ww          , Ww          , Ww          , Wo          , Wo          , Wo          , Wo          , Wo          , Wo          , Wo          , Wo          , Wo          , Wo          , Wo          , Wo          , Wo          , Wo          
Wo          , Wo          , Wo          , Wo          , Wo          , Wo          , Wo          , Wo          , Wwf         , Ww          , Ss          , Ww          , Ww          , Wo          , Wo          , Wo          , Wo          , Wo          , Wo          , Wo          , Wo          , Wo          , Wo          , Wo          , Wo          , Wo          , Wo          
Wo          , Wo          , Wo          , Wo          , Wo          , Wo          , Wo          , Wwf         , Wwf         , Ss          , Dd^Do       , Ds          , Ds          , Wwf         , Wwf         , Wo          , Wo          , Wo          , Wo          , Wo          , Wo          , Wo          , Wo          , Wo          , Wo          , Wo          , Wo          
Wo          , Wo          , Wo          , Wo          , Wo          , Wo          , Wo          , Wwf         , Ds          , Dd          , Gs          , Hd          , Dd          , Wwf         , Wwf         , Wo          , Wo          , Wo          , Wo          , Wo          , Ww          , Wo          , Ww          , Ww          , Ss          , Wo          , Wo          
Wo          , Wo          , Wo          , Wo          , Wo          , Wo          , Wo          , Ww          , Ss          , Rd          , Hd          , Rd          , Chs         , Chw         , Chw         , Ww          , Wo          , Wo          , Wo          , Wo          , Xu          , Xu          , Ur          , Xu          , Xu          , Ss          , Wo          
Wo          , Wo          , Wo          , Wo          , Wo          , Wo          , Wo          , Ww          , Ww          , Ss          , Ds          , Gs          , Gs^Ft       , 3 Khs       , Chs         , Ww          , Ww          , Ww          , Ww          , Wwf         , Xu          , Ur          , Ur          , Ur          , Ss          , Ss          , Wo          
Wo          , Wo          , Wo          , Wo          , Wo          , Wo          , Wo          , Wo          , Wo          , Ww^Vm       , Ww          , Ds          , Wwf         , Ds          , Ss          , Ww          , Wo          , Wo          , Wo          , Ss          , Ss^Vm       , Xu          , Ss          , Ur          , Wwf         , Ww^Vm       , Wo          
Wo          , Wo          , Wo          , Wo          , Ww          , Ww          , Ss          , Wo          , Wo          , Wo          , Ww          , Mm          , Wwf         , Ss          , Wo          , Wo          , Wo          , Wo          , Wo          , Wo          , Ww          , Ss          , Ww          , Ss          , Ww          , Ww          , Wo          
Wo          , Wo          , Wwf         , Ww          , Wwf         , Ss          , Xu          , Ss          , Ww          , Wo          , Wo          , Ww          , Ww          , Wwf         , Ww          , Wo          , Wo          , Wo          , Wo          , Wo          , Wo          , Ww          , Wo          , Ww          , Wo          , Wo          , Wo          
Wo          , Wwf         , Ss          , Ur          , Ur          , Ur          , Xu          , Ss          , Ww          , Wo          , Wo          , Wo          , Wo          , Wwf         , Wwf         , Wo          , Xu          , Wo          , Wo          , Wo          , Wo          , Wo          , Wo          , Wo          , Wo          , Wo          , Wo          
Wo          , Ss          , Xu          , Ur          , Ur          , Ur          , Xu          , Xu          , Ww          , Wo          , Wo          , Wo          , Wo          , Wo          , Ww          , Ss          , Xu          , Xu          , Ww          , Wo          , Wo          , Wo          , Wo          , Wo          , Wo          , Wo          , Wo          
Wo          , Ss          , Xu          , Ur          , Xu          , Uu^Vu       , Xu          , Ss          , Ww          , Wo          , Wo          , Wo          , Wo          , Wo          , Wo          , Wwf         , Ww          , Ww^Vm       , Wo          , Wo          , Wo          , Wo          , Wo          , Wo          , Wo          , Wo          , Wo          
Wo          , Wo          , Wo          , Xu          , Xu          , Xu          , Wwf         , Wwf         , Wo          , Wo          , Wo          , Wo          , Wo          , Wo          , Wo          , Wo          , Wo          , Wo          , Wo          , Wo          , Wo          , Wo          , Wo          , Wo          , Wo          , Wo          , Wo          
Wo          , Wo          , Wo          , Wo          , Wo          , Wo          , Wo          , Ww          , Ww          , Wo          , Ww          , Wo          , Wo          , Wo          , Wo          , Wo          , Wo          , Wo          , Wo          , Ww          , Ww          , Wo          , Wwf         , Wo          , Wo          , Wo          , Wo          
Wo          , Wo          , Wo          , Wo          , Wo          , Wo          , Ww^Vm       , Ww          , Ss          , Ss          , Dd          , Ww          , Ww          , Wo          , Wo          , Wo          , Ww          , Ww          , Ss          , Ss          , Dd          , Ww          , Wwf         , Wo          , Wo          , Wo          , Wo          
Wo          , Wo          , Wo          , Wo          , Wo          , Wo          , Ww          , Ss          , Gs          , Dd          , Hd          , Ds          , Ds          , Ww          , Wo          , Wo          , Ww          , Ww          , Ds          , Gs          , Rd          , Ds          , Wwf         , Wwf         , Wo          , Wo          , Wo          
Wo          , Wo          , Wo          , Wo          , Wo          , Wo          , Ww          , Ss          , Ds          , Dd^Do       , Hd          , Dd          , Dd          , Ww          , Wo          , Wo          , Ww          , Ss          , Gs          , Gs^Ft       , Hd          , Dd^Do       , Hd          , Ss          , Wo          , Wo          , Wo          
Wo          , Wo          , Wo          , Wo          , Wo          , Wo          , Wo          , Wwf         , Wwf         , Gs^Ft       , Ss          , Ds          , Ww          , Ww          , Wo          , Wo          , Ww^Vm       , Ss          , Dd          , Dd^Do       , Dd          , Hd          , Dd          , Ss          , Wo          , Wo          , Wo          
Wo          , Wo          , Wo          , Wo          , Wo          , Wo          , Wo          , Ww          , Wwf         , Wwf         , Ww          , Ww          , Wo          , Wo          , Wo          , Wo          , Ww          , Ww          , Wwf         , Rd          , Dd          , Ds          , Ww          , Wo          , Wo          , Wo          , Wo          
Wo          , Wo          , Wo          , Wo          , Wo          , Wo          , Wo          , Ww          , Wwf         , Ww          , Wo          , Wo          , Wo          , Wo          , Wo          , Wo          , Wwf         , Wwf         , Wwf         , Wwf         , Ww          , Ww          , Wo          , Wo          , Wo          , Wo          , Wo          
Wo          , Wo          , Wo          , Wo          , Wo          , Ww          , Ds          , Wwf         , Wwf         , Wo          , Wo          , Wo          , Wo          , Wo          , Wo          , Ww          , Ww          , Ww          , Wo          , Wo          , Wo          , Wo          , Wo          , Wo          , Wo          , Wo          , Wo          
Wo          , Wo          , Wo          , Wo          , Ww          , Ss          , Gs          , Ww^Vm       , Wwf         , Wo          , Ww          , Wo          , Wo          , Wo          , Wo          , Wo          , Wo          , Wo          , Wo          , Wo          , Wo          , Wo          , Wo          , Wo          , Wo          , Wo          , Wo          
Wo          , Wo          , Wo          , Wo          , Ww          , Gs          , Gs^Ft       , Rd          , Gs          , Ds          , Ss          , Wo          , Wo          , Wo          , Wo          , Wo          , Wo          , Wo          , Wo          , Wo          , Wo          , Wo          , Wo          , Wo          , Wo          , Wo          , Wo          
Wo          , Wo          , Wo          , Wo          , Ww          , Ss          , Ss          , Gs          , Ds          , Ds          , Ww          , Wo          , Wo          , Wo          , Wo          , Wo          , Wo          , Wo          , Wo          , Wo          , Wo          , Wo          , Wo          , Wo          , Wo          , Wo          , Wo          
Wo          , Wo          , Wo          , Wo          , Wo          , Ww          , Ww          , Ww          , Ww          , Ww          , Wo          , Wo          , Wo          , Wo          , Wo          , Wo          , Wo          , Wo          , Ww          , Wo          , Ww          , Wo          , Wo          , Wo          , Wo          , Wo          , Wo          
Wo          , Wo          , Wo          , Wo          , Wo          , Wo          , Wo          , Ww          , Wo          , Wo          , Wo          , Wo          , Wo          , Wo          , Wo          , Wo          , Ww          , Ww          , Ss          , Ww          , Xu          , Ww          , Xu          , Wo          , Xu          , Wo          , Wo          
Wo          , Wo          , Ww          , Wo          , Wo          , Ww^Vm       , Xu          , Ww          , Wo          , Wo          , Wo          , Wo          , Wo          , Wo          , Wo          , Ww          , Ww          , Ss          , Xu          , Xu          , Uu          , Xu          , Uu          , Xu          , Uu^Vu       , Xu          , Wo          
Wo          , Wo          , Ss          , Ss          , Ss          , Ww          , Ww          , Ww          , Wo          , Wo          , Wo          , Wo          , Wo          , Wo          , Wo          , Ww          , Ss          , Ss          , Xu          , Uu          , Ur          , Uu^Vu       , Ur          , Ur          , Ss          , Xu          , Xu          
Wo          , Wo          , Xu          , Xu          , Ur          , Ss          , Wwf         , Wo          , Wo          , Wwr         , Wo          , Wo          , Wo          , Wo          , Wo          , Ww          , Ss          , Xu          , Xu          , Ur          , Ur          , Ur          , Wwf         , Ss          , Ww          , Ww          , Xu          
Wo          , Xu          , Cud         , Uu^Vu       , Ur          , Wwf         , Wo          , Wo          , Wo          , Wo          , Wo          , Wo          , Wo          , Wo          , Ww          , Ww          , Ss          , Ss^Vm       , Ur          , Xu          , Ww          , Wwf         , Ss          , Wwf         , Uu^Vu       , Xu          , Ww          
Wo          , Xu          , Kud         , Cud         , Cud         , Ww          , Ww          , Wo          , 1 Wo        , Wo          , Wo          , Wo          , Wo          , Wo          , Ww          , Ww          , Wwf         , 2 Wwf       , Wwf         , Wwf         , Xu          , Cud         , Kud         , Ss          , Xu          , Xu          , Wo          
Wo          , Xu          , Xu          , Xu          , Ss^Vm       , Ss          , Ww          , Wo          , Wo          , Wo          , Wo          , Wo          , Wo          , Wo          , Wo          , Ww          , Wwf         , Wwf         , Wwf         , Ur          , Xu          , Cud         , Xu          , Cud         , Xu          , Ww          , Wo          
Wo          , Ww          , Ww          , Ss          , Wo          , Ww          , Wo          , Wo          , Wo          , Wo          , Wo          , Wo          , Wo          , Wo          , Wo          , Ww          , Ww          , Wwf         , Ss          , Ss^Vm       , Ss          , Xu          , Ss          , Xu          , Ss          , Ww          , Wo          
Wo          , Wo          , Wo          , Wo          , Wo          , Wo          , Wo          , Wo          , Wo          , Wo          , Wo          , Wo          , Wo          , Wwr         , Wo          , Wo          , Wo          , Ww          , Ww          , Ss          , Ww          , Ss          , Ww          , Ss          , Ww          , Ww          , Wo          
Wo          , Wo          , Wo          , Wo          , Wo          , Wo          , Wo          , Wo          , Wo          , Wo          , Wo          , Wo          , Wo          , Wo          , Wo          , Wo          , Wo          , Wo          , Wo          , Ww          , Wo          , Wo          , Wo          , Ww          , Ww          , Wo          , Wo          
