border_size=1
usage=map

Wo          , Wo          , Wwr         , Wo          , Wo          , Wo          , Wo          , Wo          , Wo          , Wo          , Wo          , Wo          , Wo          , Wo          , Wo          , Wo          , Wo          , Wo          , Wo          , Wo          , Wo          , Wo          , Wo          , Wo          , Wo          , Wo          , Wo          , Wo          , Wo          , Wo          , Wo          , Wo          , Wo          , Wo          , Wo          , Wo          , Wo          , Wo          , Wo          
Wo          , Wo          , Wo          , Wo          , Wo          , Wo          , Wo          , Wo          , Wo          , Wo          , Wo          , Wo          , Wo          , Wo          , Ww^Vm       , Xu          , Xu          , Wwf         , Wo          , Wo          , Wo          , Wo          , Wo          , Wo          , Wo          , Wo          , Wo          , Wo          , Wo          , Wo          , Wo          , Wo          , Wo          , Wo          , Wo          , Wo          , Wwr         , Wo          , Wo          
Wo          , Wo          , Wo          , Wo          , Wo          , Wo          , Ww          , Wo          , Ww          , Wo          , Ww          , Wo          , Wo          , Wo          , Wo          , Ww          , Wwf         , Wwf         , Wo          , Wo          , Wo          , Wo          , Wo          , Wo          , Wo          , Wwr         , Ww^Vm       , Wwf         , Wwf         , Wo          , Wo          , Wo          , Wo          , Wo          , Wo          , Wo          , Wo          , Wo          , Wo          
Wo          , Wo          , Wo          , Wo          , Ww          , Ww          , Ds          , Ww          , Ss          , Ww          , Ww          , Ww          , Wo          , Wo          , Wo          , Wo          , Wo          , Wo          , Wwr         , Wo          , Wo          , Wo          , Wo          , Wo          , Wo          , Wo          , Wo          , Wwf         , Wo          , Wo          , Wo          , Wo          , Chw         , Ww          , Wo          , Wo          , Wo          , Wo          , Wo          
Wo          , Wo          , Wo          , Ww          , Ds          , Ds          , Gs^Ft       , Re          , Re          , Gs          , Gs          , Ww          , Ww          , Wo          , Wo          , Wo          , Wo          , Wo          , Wo          , Wo          , Wo          , Wo          , Wo          , Wo          , Wo          , Wo          , Wo          , Ww          , Xu          , Wo          , Wo          , Wwf         , Wwf         , Ww          , Xu          , Wo          , Xu          , Wo          , Wo          
Wwr         , Wo          , Wo          , Ww          , Ds          , Gs          , Ss          , Gs^Ft       , Hh          , Re          , Gs^Ft       , Ss          , Ww          , Ww          , Wo          , Wo          , Xu          , Wo          , Wo          , Wo          , Mm          , Wo          , Wo          , Wwr         , Wo          , Wo          , Wo          , Wwr         , Wo          , Wo          , Wo          , Wo          , Wo          , Wo          , Chw         , Xu          , Chs         , Xu          , Wo          
Wo          , Ww^Vm       , Wo          , Ww          , Ww          , Ss          , Ww          , Hh          , Hh          , Hh          , Hh          , Gs^Ft       , Gs          , Ww          , Ww          , Wwf         , Wo          , Wo          , Wo          , Wo          , Mm^Vhh      , Mm^Xm       , Wo          , Wo          , Wo          , Wo          , Ww          , Wo          , Ww          , Wo          , Wo          , Wo          , Ww          , Ss^Vm       , Chs         , 4 Khr       , Chs         , Ww          , Wo          
Wo          , Wo          , Wo          , Ww          , 1 Ww        , Ww          , Ww          , Ww          , Hh          , Hh^Vc       , Hh          , Gs          , Gs^Ft       , Ss          , Ww          , Ww          , Ww          , Wo          , Wo          , Wo          , Wo          , Wwf         , Ww          , Wo          , Wo          , Wo          , Ss          , Wwf         , Ds          , Ww          , Wo          , Wo          , Wo          , Ss          , Chw         , Chw         , Chw         , Ss^Vm       , Wo          
Wo          , Wo          , Wo          , Wo          , Ww          , Ww^Bw|      , Ww          , Ss          , Mm          , Mm          , Hh          , Gs^Ft       , Gs^Ft       , Gs          , Ds          , Ww          , Ww          , Wo          , Wo          , Wo          , Wwr         , Wo          , Wo          , Wo          , Wo          , Ss          , Xu          , Xu          , Xu          , Ds          , Wo          , Wo          , Ww          , Ww          , Ww          , Ss          , Ss          , Ss          , Wo          
Wo          , Wo          , Wo          , Ww          , Gs          , Gs          , Gs          , 2 Gs^Vht    , Hh          , Mm          , Re          , Re          , Gs          , Ds          , Ds          , Ww          , Ww          , Wo          , Ww^Vm       , Wo          , Wo          , Wo          , Wo          , Wo          , Wo          , Ds          , Xu          , Ql          , Xu          , Ss^Vm       , Wo          , Wo          , Wo          , Wo          , Chw         , Wwf         , Wo          , Wo          , Wo          
Wo          , Wo          , Ww          , Ww          , Ds          , Dd          , Ds          , Gs^Ft       , Gs^Ft       , Hh          , Re          , Re          , Gs^Vht      , Ds          , Ww          , Ww          , Ww          , Wo          , Ww          , Xu          , Wo          , Wo          , Wo          , Wo          , Wo          , Ds^Dr       , Ds          , Xu          , Ss          , Ss          , Wo          , Wo          , Wo          , Ww          , Ww          , Wwf         , Wo          , Wo          , Wo          
Wo          , Wo          , Wo          , Ww          , Ww          , Ds          , Ww          , Ds          , Gs^Ft       , Re          , Re          , Gs^Ft       , Ss          , Ss          , Ww          , Ww          , Wo          , Wo          , Wo          , Wo          , Wo          , Wo          , Wwf         , Wwf         , Ww          , Ww          , Wo          , Wwf         , Wo          , Wo          , Wo          , Wo          , Wo          , Wo          , Wo          , Wo          , Wo          , Wwr         , Wo          
Wo          , Wo          , Wo          , Wo          , Ww          , Ww          , Ww          , Ss          , Ss          , Re          , Khr         , Chs         , Ss^Vhs      , Ww          , Ww          , Wo          , Wo          , Wo          , Wo          , Wo          , Wo          , Wo          , Wo          , Wo          , Wo          , Wo          , Wo          , Wo          , Wo          , Wo          , Wo          , Wo          , Wo          , Wo          , Wo          , Wo          , Wo          , Wo          , Wo          
Wo          , Wo          , Wo          , Wo          , Wo          , Wo          , Ww          , Ss          , Ss          , Ch          , Chw         , Chw         , Ww          , Ww          , Ww          , Wo          , Wwr         , Wo          , Wo          , Wo          , Wo          , Wo          , Wo          , Wo          , Wo          , Wo          , Wo          , Wo          , Wo          , Wo          , Xu          , Xu          , Ww          , Wo          , Wo          , Xu          , Ww^Vm       , Wo          , Wo          
Wo          , Wo          , Wo          , Wo          , Wo          , Wo          , Wo          , Ww          , Ww          , Ww          , Wo          , Ww          , Wo          , Ww          , Wo          , Wo          , Wo          , Wo          , Wo          , Wo          , Wo          , Wo          , Wo          , Wo          , Wo          , Wo          , Wo          , Wo          , Wo          , Ww          , Wwf         , Xu          , Wo          , Wo          , Wo          , Wo          , Wo          , Wo          , Wo          
Wo          , Wo          , Wwr         , Wo          , Wo          , Wo          , Wo          , Wo          , Wo          , Wo          , Wo          , Wo          , Wo          , Wo          , Wo          , Wo          , Wo          , Wo          , Ds          , Xu          , Xu          , Ww          , Wo          , Wo          , Wwr         , Wo          , Wo          , Wo          , Wo          , Wo          , Wo          , Wo          , Wo          , Wo          , Wwr         , Wo          , Wo          , Wo          , Wo          
Wo          , Wo          , Wo          , Wo          , Wo          , Wo          , Wo          , Wo          , Wo          , Wo          , Wo          , Wo          , Wo          , Wo          , Wo          , Wo          , Wo          , Wo          , Wo          , Xu          , Xu          , Wwf         , Wo          , Wo          , Wo          , Wo          , Wo          , Wo          , Wo          , Wo          , Wo          , Wo          , Wo          , Wo          , Wo          , Wo          , Wo          , Wo          , Wo          
Wo          , Wo          , Wo          , Wo          , Wo          , Wo          , Wo          , Wo          , Wo          , Wo          , Wo          , Wo          , Wo          , Wo          , Wo          , Wo          , Wo          , Wo          , Wo          , Ww^Vm       , Wo          , Wo          , Wo          , Wo          , Wo          , Wo          , Wo          , Wo          , Wo          , Wo          , Wo          , Wo          , Wo          , Wo          , Wo          , Wo          , Wo          , Wo          , Wo          
Wo          , Wo          , Wo          , Wo          , Wo          , Wo          , Wo          , Wo          , Wo          , Wo          , Wo          , Wwr         , Wo          , Wo          , Wo          , Xu          , Xu          , Wwf         , Wo          , Wo          , Wo          , Wo          , Wo          , Wo          , Wo          , Wo          , Wo          , Wo          , Wo          , Wo          , Wo          , Wo          , Wo          , Wo          , Wo          , Wo          , Wo          , Wo          , Wo          
