border_size=1
usage=map

Wo          , Wo          , Wo          , Wo          , Wo          , Wo          , Wo          , Wo          , Wo          , Wo          , Wo          , Wo          , Wo          , Wo          , Wo          , Wo          , Wo          
Wo          , Wo          , Wo          , Wo          , Xu          , Xu          , Xu          , Wo          , Wo          , Wo          , Wo          , Wo          , Wo          , Wo          , Wo          , Wo          , Wo          
Wo          , Wo          , Ww          , Wo          , Wo          , Xu          , Wo          , Wo          , Wwf         , Wo          , Wo          , Wo          , Wo          , Wo          , Wo          , Wo          , Wo          
Wo          , Wwf         , Ww          , Ww          , Ww          , Wo          , Ww          , Wo          , Wwr         , Wo          , Wo          , Wo          , Wo          , Wo          , Wo          , Wo          , Wo          
Wo          , Ww          , Ww          , Wwr         , Ww          , Ww          , Ww          , Ww          , Wo          , Wo          , Xu          , Wo          , Wo          , Wo          , Wo          , Wo          , Wo          
Wo          , Ww          , Ww          , Ww          , Ww          , Wo          , Wwf         , Ww          , Wo          , Wo          , Xu          , Xu          , Wo          , Wo          , Ww          , Wo          , Wo          
Wo          , Wwf         , Wo          , Ww          , Wo          , Ww          , Ds          , 1 Wwf       , Wwf         , Wo          , Wo          , Wo          , Ww          , Ww          , Wwf         , Wwf         , Wo          
Wo          , Xu          , Wo          , Wo          , Ww          , Ss^Vm       , Ss          , Ds          , Ds          , Ww          , Wo          , Ww          , Ww          , Ww          , Wo          , Wo          , Wo          
Wo          , Xu          , Xu          , Xu          , Wo          , Ss          , Ss          , Ss          , Ds          , Wwf         , Ww          , Ww          , Wwr         , Wo          , Ww          , Wo          , Wo          
Wo          , Wo          , Wo          , Xu          , Wo          , Wo          , Wo          , Ds          , Ww          , Wwf         , Ww          , Ww          , Ww          , Ww          , Ww          , Ww          , Wwf         
Wo          , Wo          , Wo          , Wo          , Wo          , Wwf         , Ww          , Wwr         , Ww          , Ww          , Wo          , Wwf         , Wo          , Ww          , Wwr         , Ww          , Wo          
Wo          , Wo          , Wo          , Wo          , Wo          , Wo          , Ww          , Ww          , Wo          , Wo          , Xu          , Xu          , Xu          , Wo          , Wo          , Ww          , Ww          
Wo          , Wo          , Wo          , Wo          , Wo          , Wo          , Wo          , Ww          , Wo          , Wo          , Wo          , Wo          , Wo          , Xu          , Wo          , Wo          , Wo          
Wo          , Wo          , Wo          , Wo          , Wo          , Wo          , Wo          , Wo          , Wo          , Wo          , Wo          , Wo          , Wo          , Wo          , Wo          , Wo          , Wo          
Wo          , Wo          , Wo          , Wo          , Wo          , Wo          , Wo          , Wo          , Wo          , Wo          , Wo          , Wo          , Wo          , Wo          , Wo          , Wo          , Wo          
