border_size=1
usage=map

Wo          , Wo          , Ww          , Wo          , Ss          , Ww          , Ss          , Ss          , Mm          , Wo          , Mm^Xm       , Wo          , Mm^Xm       , Wo          , Ww          , Wo          , Wo          , Wo          , Ww          , Wo          , Wo          , Wo          , Wo          , Wo          , Ss          , Wo          , Wo          , Wo          
Wo          , Wo          , Wo          , Ww          , Ww          , Ss          , Ss          , Ss          , Ss          , Mm          , Mm          , Mm          , Mm          , Wwr         , Wo          , Wo          , Wo          , Chw         , Ww          , Ww          , Ww          , Wo          , Wo          , Wo          , Ss          , Wo          , Ww          , Wo          
Wo          , Wo          , Wo          , Wo          , Wo          , Ss^Vm       , Wo          , Ww          , Wo          , Ds          , Ds          , Ds          , Wwr         , Mm          , Wo          , Wo          , Wo          , Chw         , Wo          , Ww          , Wo          , Wo          , Wo          , Wo          , Ss          , Wo          , Ww          , Wo          
Wo          , Wo          , Wo          , Wo          , Wo          , Wo          , Wo          , Wo          , Wo          , Wo          , Wo          , Wo          , Wo          , Wo          , Wo          , Wo          , Wo          , Chw         , Wo          , Wo          , Ss          , Wo          , Wo          , Ww^Vm       , Ss          , Ss          , Wo          , Ww          
Wo          , Wo          , Wo          , Wo          , Wo          , Wo          , Wo          , Wo          , Wo          , Wo          , Wo          , Wo          , Wo          , Wo          , Wo          , Wo          , Wo          , Ww          , Ww          , Ss          , Ss^Vm       , Wo          , Ss          , Ds          , Ds          , Ds          , Wo          , Ww          
Wo          , Wo          , Chw         , Wo          , Chs         , Wo          , Wo          , Wo          , Wo          , Wo          , Wo          , Wo          , Wo          , Wo          , Wo          , Wo          , Wo          , Ww          , Wo          , Wo          , Wo          , Wo          , Ss          , Ss          , Ss          , Ds          , Ss          , Ss          
Wo          , Ww          , Chw         , 2 Khw       , Chs         , Wo          , Wo          , Wo          , Wo          , Wo          , Wo          , Wwf         , Ww          , Wo          , Wo          , Wo          , Wo          , Chw         , Ww          , Wo          , Wo          , Wo          , Ww          , Ss          , Ss^Vm       , Ss          , Ss          , Wo          
Wo          , Wwr         , Ww          , Ss          , Wo          , Wwf         , Wo          , Wo          , Wo          , Wo          , Wo          , Wwf         , Wo          , Wo          , Wo          , Wo          , Wo          , Ch          , 1 Kh        , Wo          , Wo          , Wo          , Ww          , Ww          , Ww          , Wo          , Wo          , Wo          
Wo          , Wo          , Wo          , Wo          , Wo          , Wo          , Wo          , Wo          , Ww          , Wo          , Wo          , Wo          , Wo          , Wo          , Wo          , Wo          , Wo          , Ch          , Ch          , Ww          , Wo          , Wo          , Wo          , Ww          , Ss          , Ww          , Wo          , Wo          
Wo          , Wo          , Gs          , Wo          , Wo          , Wo          , Wo          , Wo          , Wwf         , Wo          , Wo          , Wo          , Wo          , Wo          , Wo          , Wo          , Wo          , Wo          , Wo          , Chw         , Ww          , Ww          , Wo          , Wo          , Wo          , Ss          , Ss          , Wo          
Wo          , Ds          , Gs          , Ww^Vm       , Ww          , Wo          , Wo          , Wo          , Wo          , Wwf         , Wo          , Wo          , Wo          , Wo          , Wo          , Wo          , Wo          , Wo          , Wo          , Wo          , Wo          , Ww          , Chw         , Ww          , Ww          , Ww          , Wo          , Wo          
Wo          , Ds          , Gs^Ft       , Ds          , Ww          , Wo          , Wo          , Wo          , Wo          , Wo          , Wo          , Wo          , Wwr         , Wo          , Wo          , Wo          , Wo          , Wo          , Wo          , Wo          , Wo          , Wo          , Wo          , Chw         , Chw         , Wo          , Wo          , Wo          
Wo          , Wo          , Wo          , Gs^Ft       , Wo          , Wo          , Wo          , Wo          , Wo          , Wo          , Wo          , Ww          , Wwr         , Ww          , Wo          , Wo          , Wo          , Wo          , Wo          , Wo          , Wo          , Wo          , Wo          , Wo          , Wo          , Ww          , Ww          , Ww          
Wo          , Wo          , Wo          , Wo          , Wo          , Wo          , Wo          , Wo          , Wo          , Wo          , Wo          , Wo          , Wo          , Ww          , Wo          , Wo          , Wo          , Wo          , Wo          , Wo          , Wo          , Wo          , Wo          , Wo          , Wo          , Wo          , Wo          , Wo          
Wo          , Wo          , Wo          , Wo          , Wo          , Wo          , Wo          , Wo          , Wo          , Wo          , Wo          , Wo          , Wo          , Wo          , Wwf         , Wo          , Wo          , Ww          , Wo          , Wo          , Wo          , Wo          , Wo          , Wo          , Wo          , Wo          , Wo          , Wo          
Wo          , Wo          , Wo          , Wo          , Wo          , Wo          , Wo          , Wo          , Wo          , Wo          , Wo          , Wo          , Wo          , Wo          , Wo          , Wo          , Wo          , Wo          , Wo          , Wo          , Wo          , Wo          , Wo          , Wo          , Wo          , Wo          , Ww          , Wo          
Wo          , Wo          , Wo          , Wo          , Wo          , Ww          , Wwf         , Wo          , Wo          , Wo          , Wo          , Wo          , Wo          , Wo          , Wo          , Wo          , Wo          , Wo          , Wo          , Wo          , Wo          , Wo          , Wo          , Wo          , Ww          , Wo          , Ww          , Ww          
Wo          , Wo          , Wo          , Wo          , Wo          , Wo          , Wo          , Wo          , Wo          , Wo          , Wo          , Wo          , Wo          , Wo          , Ww          , Ww          , Wo          , Wo          , Wo          , Wo          , Wo          , Ww          , Ww          , Ww          , Ww          , Ww          , Wo          , Mm          
Wo          , Wo          , Wo          , Wo          , Wo          , Wo          , Wo          , Wo          , Wo          , Wo          , Wo          , Wo          , Wo          , Wo          , Wo          , Wo          , Wo          , Wo          , Wo          , Wo          , Wo          , Ww          , Ww          , Mm          , Mm          , Mm          , Mm^Xm       , Mm          
Wo          , Wo          , Wo          , Wo          , Ww          , Wo          , Wo          , Wo          , Wo          , Wo          , Wo          , Wo          , Wo          , Wo          , Wo          , Wo          , Wo          , Wwf         , Wwf         , Wo          , Wo          , Wwr         , Ww          , Ww          , Ss          , Mm          , Mm^Xm       , Wo          
Wo          , Wo          , Wo          , Ww          , Wwf         , Wo          , Wo          , Wo          , Wo          , Wo          , Xu          , Xu          , Ww          , Wo          , Wo          , Ww          , Ww          , Ww          , Wwf         , Wwf         , Wo          , Wo          , Wo          , Ww          , Ss          , Mm          , Mm          , Mm          
Wo          , Wo          , Wo          , Wo          , Wwf         , Wo          , Wo          , Wo          , Wo          , Xu          , Xu          , Ss^Vm       , Ww          , Ww          , Chw         , Wo          , Ss          , Wo          , Wo          , Wo          , Wo          , Wo          , Wo          , Wo          , Wo          , Ww^Vm       , Mm          , Ss          
Wo          , Wo          , Wo          , Wo          , Wo          , Wo          , Ww          , Wo          , Wo          , Wo          , Wo          , Ww          , Ww          , Wo          , Chw         , 3 Khw       , Chs         , Ss          , Wo          , Wo          , Wo          , Wo          , Wo          , Wo          , Wo          , Wo          , Ww          , Ww          
Wo          , Wo          , Wo          , Wo          , Wo          , Wo          , Wo          , Wo          , Wo          , Wo          , Wo          , Ww          , Wo          , Wo          , Wo          , Chs         , Wo          , Wo          , Wo          , Wo          , Wo          , Ww          , Ww          , Wwf         , Wo          , Wo          , Wo          , Wo          
Wo          , Wo          , Wo          , Wo          , Wo          , Wo          , Wo          , Wo          , Wo          , Wo          , Wo          , Wo          , Wo          , Wo          , Wo          , Wo          , Wo          , Wo          , Wo          , Wo          , Wo          , Ww          , Wo          , Wwf         , Wo          , Wo          , Wo          , Wo          
Wo          , Wo          , Wo          , Wo          , Wo          , Wo          , Wo          , Wo          , Wo          , Wo          , Wo          , Wo          , Wo          , Wo          , Wo          , Wo          , Wo          , Wo          , Wo          , Wo          , Wo          , Wo          , Wo          , Wo          , Wo          , Wo          , Wo          , Wo          
