border_size=1
usage=map

Wo          , Wo          , Wo          , Wo          , Wwr         , Wo          , Wo          , Wo          , Wo          , Wo          , Wo          , Wo          , Wo          , Wo          , Wwr         , Wo          , Wo          , Wo          , Wo          
Xu          , Xu          , Ss          , Wo          , Wo          , Wo          , Wo          , Wo          , Ss          , Wo          , Ww          , Wo          , Wo          , Wo          , Wo          , Wo          , Ww          , Wo          , Wwr         
Wo          , Xu          , Ss          , Ss          , Wo          , Wo          , Ww          , Ss          , Chw         , Ww          , Chs         , Wo          , Wo          , Wo          , Wo          , Wo          , Wwf         , Wo          , Wo          
Wo          , Wo          , Wwf         , Wo          , Wwf         , Wo          , Ww          , Chs         , Ss          , 1 Khs       , Ww          , Chw         , Ww          , Wo          , Wwf         , Wwf         , Ww^Vm       , Ww          , Wo          
Wo          , Wwf         , Ww          , Wwf         , Ww          , Wwf         , Ww          , Ww          , Ww          , Wo          , Wwr         , Ww          , Wo          , Wwf         , Ww          , Ww          , Ss          , Xu          , Xu          
Wo          , Ww          , Ww          , Wwr         , Wo          , Wwf         , Wo          , Wo          , Wo          , Ww          , Wo          , Wo          , Wo          , Wwf         , Ww          , Ds          , Ce          , Xu          , Ds          
Wo          , Wo          , Ww^Vm       , Wo          , Wo          , Wwr         , Ww          , Wo          , Wwf         , Wo          , Wwf         , Wwr         , Wo          , Wo          , Wo          , Ds          , Ce          , 2 Ke        , Ds          
Wo          , Ds          , Xu          , Wo          , Wo          , Ww          , Ww          , Wo          , Wwr         , Wwf         , Ww          , Wwf         , Wwf         , Wo          , Ww          , Ss          , Ss^Vhs      , Ce          , Ss          
Wo          , Ds          , Ww          , Wo          , Wo          , Wo          , Wo          , Wo          , Wo          , Ww          , Wwr         , Ww          , Wo          , Wo          , Ww          , Wwr         , Ww          , Ww          , Ww          
Wo          , Wo          , Wo          , Ww          , Ww          , Wwf         , Wo          , Wo          , Wo          , Wo          , Wo          , Wo          , Wo          , Wo          , Wwf         , Wo          , Wo          , Ww          , Wo          
Ww          , Wo          , Ww          , Wwr         , Wo          , Wo          , Wo          , Wo          , Wo          , Wo          , Wo          , Wo          , Wo          , Wwf         , Ww^Vm       , Wwf         , Wo          , Wwf         , Wo          
Wo          , Wo          , Xu          , Ww          , Xu          , Ww^Vm       , Wo          , Wo          , Wo          , Wo          , Wo          , Wo          , Wo          , Wo          , Xu          , Ww          , Ww          , Ww          , Wo          
Wo          , Ww          , Wo          , Xu          , Wo          , Wo          , Wo          , Wo          , Wo          , Wo          , Wo          , Wo          , Wo          , Wo          , Wo          , Xu          , Xu          , Wo          , Wo          
Wo          , Ww          , Ww          , Wo          , Wo          , Wo          , Wo          , Wo          , Wo          , Wo          , Wo          , Wo          , Wo          , Wo          , Wo          , Wo          , Ww          , Wo          , Wo          
Wo          , Wo          , Wo          , Wo          , Wo          , Wo          , Wo          , Wo          , Wo          , Wo          , Wo          , Wo          , Wo          , Wo          , Wo          , Ww          , Ww          , Wo          , Wo          
Wo          , Wwf         , Wwf         , Ww          , Ww          , Ww          , Ww          , Wo          , Ww^Vm       , Wwf         , Wwf         , Wo          , Wo          , Wo          , Ww          , Ww          , Ww^Vm       , Wo          , Wo          
Wo          , Wo          , Ww          , Wo          , Wo          , Ww          , Wo          , Wo          , Wwf         , Wwf         , Ww          , Ww          , Ww          , Wo          , Wwf         , Ww          , Wo          , Wwf         , Wwf         
Wo          , Wo          , Ww          , Wo          , Wwf         , Wwf         , Wo          , Wo          , Wo          , Wo          , Wo          , Wo          , Wo          , Ww          , Ww          , Wo          , Wo          , Wo          , Wo          
Ww          , Ww          , Ww^Vm       , Wo          , Wo          , Ww          , Ss          , Wo          , Ss          , Ww          , Ss          , Wo          , Wo          , Ww          , Wo          , Ww^Vm       , Wo          , Wo          , Ww          
Ww          , Ww          , Wo          , Wo          , Wwf         , Ss          , Xu          , Ds          , Cud         , Rd          , Xu          , Ww          , Wo          , Wo          , Wo          , Wo          , Wo          , Ww          , Ww          
Wo          , Wo          , Wo          , Wwf         , Wo          , Wo          , Xu          , Cud         , 3 Kud       , Cud         , Xu          , Ss          , Wo          , Wo          , Ww          , Wo          , Wwf         , Wo          , Wo          
Wo          , Wo          , Ww          , Wwf         , Wo          , Wo          , Wo          , Xu          , Ww          , Xu          , Ww          , Ss^Vm       , Wo          , Wo          , Ww          , Ww          , Wwf         , Wo          , Wo          
Wo          , Wo          , Wo          , Ww          , Wo          , Wo          , Wo          , Wo          , Wo          , Ww          , Wo          , Wo          , Wo          , Wo          , Wo          , Wo          , Wo          , Wwf         , Wo          
