border_size=1
usage=map

Wo          , Wo          , Wo          , Wo          , Ww          , Ww          , Mm          , Ww          , Wo          , Wo          , Wo          , Wo          , Wo          , Wo          , Wo          , Wo          , Wo          , Wo          , Wo          , Wo          , Ww          , Wo          
Wo          , Wo          , Wo          , Ww          , Ss          , Ss          , Hh          , Wwf         , Ww          , Wo          , Wo          , Wo          , Wo          , Wo          , Wo          , Wo          , Ww          , Ww          , Ww          , Wo          , Ww          , Ww          
Wo          , Wo          , Wo          , Ww^Vm       , Mm          , Mm          , Hh          , Wwf         , Ww          , Wo          , Wo          , Wo          , Wo          , Wo          , Wo          , Wo          , Chw         , Chw         , Chw         , Ww          , Mm          , Mm          
Wo          , Wo          , Ww          , Ss          , Mm          , Mm          , Mm          , Ss          , Ww          , Wo          , Wo          , Wo          , Wo          , Wo          , Wo          , Ww          , Chw         , 1 Khw       , Chs         , Wwf         , Mm          , Mm          
Wo          , Wo          , Ww          , Mm          , Mm          , Hh          , Hh          , Ss          , Wwf         , Ww          , Wo          , Wo          , Wo          , Wo          , Ww          , Ww          , Ss          , Ss          , Hh          , Ss^Vm       , Mm          , Hh          
Wo          , Wo          , Wwf         , Mm          , Mm          , Mm          , Ww          , Ww          , Ss          , Ww          , Wo          , Wo          , Wo          , Wo          , Ww          , Ww          , Mm          , Hh          , Mm          , Wwf         , Wo          , Mm          
Wo          , Ww          , Wwf         , Mm          , Mm          , Wwf         , Mm          , Mm          , Mm          , Ww^Vm       , Ww          , Wo          , Wo          , Wo          , Ww          , Mm          , Mm          , Mm          , Mm          , Wo          , Wo          , Ww          
Wo          , Ww          , Ss          , Ss          , Mm          , Mm          , Mm          , Mm          , Hh          , Mm          , Ww          , Wo          , Wo          , Wo          , Ww^Vm       , Ss          , Mm          , Hh          , Mm          , Ww^Vm       , Hh          , Ss          
Ww          , Ww          , Mm          , Mm          , Mm          , Mm          , Mm          , Hh          , Mm          , Mm          , Ww          , Wo          , Wo          , Wo          , Ww          , Mm          , Mm          , Mm          , Ss          , Mm          , Ww          , Hh          
Ww          , Ww          , Mm          , Hh          , Mm          , Mm          , Mm          , Hh          , Mm          , Wwf         , Ww          , Wo          , Wo          , Ww          , Ww          , Mm          , Mm          , Ww          , Ww^Vm       , Hh          , Ww          , Wwf         
Wo          , Ww          , Ss          , Hh          , Ww          , Mm          , Mm          , Mm          , Ss          , Wwf         , Wo          , Wo          , Wo          , Wo          , Ww          , Mm          , Mm          , Mm          , Mm          , Mm          , Wwf         , Wwf         
Wo          , Ww          , Wwf         , Ww          , Mm          , Mm          , Mm          , Ss^Vm       , Wwf         , Ww          , Wo          , Wo          , Wo          , Wo          , Ww          , Wwf         , Mm          , Mm          , Ss          , Ww          , Wo          , Wo          
Wo          , Wo          , Wwf         , Ss^Vm       , Mm          , Mm          , Mm          , Ss          , Wwf         , Ww          , Wo          , Wo          , Wo          , Wo          , Ww          , Wwf         , Mm          , Mm          , Ss          , Ww          , Wo          , Wo          
Wo          , Wo          , Wo          , Ss          , Mm          , Hh          , Ss          , Wwf         , Ww          , Ww          , Wo          , Wo          , Wo          , Wo          , Wo          , Wwf         , Ss^Vm       , Mm          , Hh          , Ww          , Ww          , Wo          
Wo          , Wo          , Wo          , Ww          , Mm          , Hh          , Ss          , Ww          , Ww          , Wo          , Wo          , Wo          , Wo          , Wo          , Wo          , Ww          , Ww          , Hh          , Hh          , Ww          , Ww^Vm       , Ww          
Ww          , Ww          , Ww          , Ww          , Ww^Vm       , Mm          , Mm          , Ww^Vm       , Wo          , Wo          , Wo          , Wo          , Wo          , Wo          , Wo          , Ww          , Ww          , Ss          , Mm          , Ww          , Ss          , Hh          
Hh          , Hh          , Mm          , Ww          , Ww          , Ww          , Ww          , Ww          , Wwf         , Wo          , Wo          , Wo          , Wo          , Wo          , Wo          , Wo          , Ww          , Mm          , Mm          , Wwf         , Hh          , Hh          
Hh          , Mm          , Ww          , Hh          , Ww          , Ww          , Chw         , Chw         , Chw         , Wo          , Wo          , Wo          , Wo          , Wo          , Wo          , Wo          , Ww^Vm       , Mm          , Mm          , Wwf         , Hh          , Hh          
Ss          , Mm          , Hh          , Ss^Vhs      , Ww          , Wwf         , Chw         , Chw         , Chw         , Wo          , Wo          , Wo          , Wo          , Wo          , Wo          , Wo          , Ww          , Ss          , Ss          , Ww          , Mm          , Mm          
Ww          , Ss          , Ww^Vm       , Ww          , Wo          , Wwf         , Chw         , 2 Khw       , Chw         , Wo          , Wo          , Wo          , Wo          , Wo          , Wo          , Wo          , Wo          , Ww          , Ww          , Ww          , Ww^Vm       , Ss          
Wo          , Ww          , Wo          , Ww          , Wo          , Wo          , Wo          , Wo          , Wo          , Wo          , Wo          , Wo          , Wo          , Wo          , Wo          , Wo          , Wo          , Ww          , Wo          , Wo          , Wo          , Ww          
