border_size=1
usage=map

Wo          , Wo          , Wo          , Wo          , Wo          , Wo          , Wo          , Wo          , Wo          , Wo          , Wo          , Wo          , Wo          , Wo          , Wo          , Wo          , Wo          , Wo          , Ww          , Wo          , Wo          , Wo          , Wo          , Wo          , Wo          , Wo          
Wo          , Wo          , Ss          , Ss          , Gs          , Gs          , Gs          , Wo          , Wo          , Wo          , Wo          , Wo          , Wo          , Wo          , Chw         , Wo          , Wo          , Ww          , Ww          , Ww          , Ww          , Wo          , Wo          , Wo          , Wo          , Wo          
Wo          , Ds          , Ds          , Gs          , Ds          , Gs          , Dd^Do       , Ds          , Ww^Vm       , Wo          , Wo          , Wo          , Wo          , Chw         , 1 Khw       , Chw         , Wo          , Ww          , Ww          , Ww          , Ss          , Wo          , Wo          , Wo          , Wo          , Wo          
Wo          , Ww^Vm       , Wwf         , Wwf         , Ww          , Gs          , Gs          , Ds          , Wwf         , Ww          , Ww          , Ww          , Wo          , Chw         , Chw         , Chw         , Wo          , Ww          , Ss          , Ss          , Hh          , Hh          , Wo          , Wo          , Wo          , Wo          
Wo          , Ww          , Ww          , Wwf         , Ww          , Ww^Vm       , Gs          , Ds          , Wwf         , Wwf         , Ww          , Ww          , Ww          , Wo          , Wo          , Wo          , Wo          , Wo          , Wwf         , Mm          , Mm          , Hh          , Ww          , Ww          , Wwr         , Wwr         
Wwr         , Ww          , Ww          , Ww          , Ww          , Ww          , Wo          , Ds          , Ds          , Ww          , Ww          , Ww          , Ww          , Ww          , Ww          , Wo          , Ww^Vm       , Wwf         , Hh          , Mm          , Hh          , Ww^Vm       , Ww          , Wwr         , Ww          , Wo          
Wo          , Wwr         , Wwr         , Wwr         , Wwr         , Wo          , Wwr         , Wo          , Ww          , Ww          , Ww          , Ww          , Ww          , Ww          , Ww          , Wo          , Ww          , Hh          , Ss          , Hh          , Ww          , Ww          , Wwr         , Wwr         , Ds          , Wo          
Wo          , Wo          , Wo          , Wo          , Wo          , Ww          , Ww          , Wo          , Wo          , Ww          , Wwr         , Ww          , Ww          , Ww          , Ww          , Ww          , Hh          , Hh          , Ww          , Ww          , Wo          , Ww          , Ww          , Ww          , Ds          , Wo          
Wo          , Wo          , Wo          , Wo          , Wo          , Wo          , Wo          , Wwr         , Wwr         , Wwr         , Wwr         , Wo          , Wwr         , Wo          , Ww          , Ww          , Ww          , Ww          , Wwr         , Wo          , Ds          , Gs          , Gs          , Gs          , Ds          , Wo          
Wo          , Wo          , Wo          , Wo          , Wwf         , Wo          , Wwf         , Wo          , Wo          , Wo          , Wo          , Wwr         , Wo          , Wwr         , Wwr         , Ww          , Ww          , Wwr         , Wo          , Ds          , Ds          , Dd^Do       , Ss          , Ss^Vm       , Ss          , Wo          
Wo          , Wo          , Hh          , Mm          , Mm          , Wwf         , Hh          , Ww^Vm       , Gs          , Gs          , Gs          , Ds          , Wo          , Wo          , Wo          , Ww          , Wo          , Wwr         , Wo          , Ds          , Wo          , Ss          , Wo          , Wo          , Wo          , Wo          
Wo          , Ww          , Ww          , Hh          , Wwf         , Hh          , 2 Khr       , Ds          , Ds          , Dd^Do       , Ds          , Ds          , Wo          , Wo          , Wo          , Wo          , Wo          , Wwr         , Wo          , Wo          , Wo          , Wo          , Wwr         , Wo          , Wwr         , Wo          
Ww          , Ww          , Ww          , Ww^Vm       , Chw         , Chw         , Chr         , Chr         , Gs          , Ds          , Gs          , Ww^Vm       , Ww          , Wo          , Wwr         , Wo          , Wo          , Wwr         , Ww          , Wo          , Wwr         , Wwr         , Ww^Vm       , Wwr         , Wo          , Wwr         
Ww          , Ww          , Ww          , Wo          , Wo          , Chw         , Wo          , Gs          , Wo          , Gs          , Ww          , Ww          , Wwr         , Wwr         , Wo          , Wo          , Wo          , Wwr         , Ww          , Wwr         , Wo          , Wo          , Wo          , Wo          , Wo          , Wo          
Ww          , Ww          , Ww          , Ww          , Wo          , Wo          , Wo          , Wo          , Ww          , Ww          , Wwr         , Wwr         , Wwr         , Wwr         , Wo          , Wo          , Wo          , Wo          , Ww          , Ww          , Chw         , Ww          , Ww          , Wo          , Wo          , Wo          
Ww          , Ww          , Ww          , Wo          , Wo          , Wo          , Wo          , Ww          , Ww          , Wwr         , Ww          , Ww          , Wo          , Wo          , Wo          , Wo          , Ww          , Wo          , Ww          , Chw         , Chw         , 3 Khw       , Ww          , Ww          , Wo          , Wo          
Wo          , Wo          , Wo          , Wo          , Wo          , Wo          , Wo          , Ww          , Ww          , Wwr         , Ww          , Wo          , Wo          , Wo          , Ww          , Ww          , Ww          , Ww          , Wo          , Chw         , Chw         , Chw         , Ww          , Ww          , Wo          , Wo          
Wo          , Wo          , Wo          , Wo          , Wo          , Wo          , Wo          , Wo          , Gs          , Ww          , Wo          , Wo          , Hh          , Ss          , Hh          , Ss          , Hh          , Ww          , Wo          , Wo          , Wo          , Wo          , Wo          , Wo          , Wo          , Wo          
Wo          , Wo          , Wo          , Wo          , Wo          , Wo          , Gs          , Gs          , Ds          , Ds          , Wo          , Wo          , Ww          , Hh          , Ww^Vm       , Mm          , Mm          , Mm          , Ww^Vm       , Wo          , Wo          , Wo          , Wwf         , Wo          , Wo          , Wo          
Wo          , Wo          , Ww          , Wo          , Wo          , Ww^Vm       , Gs          , Dd^Do       , Wo          , Wo          , Wo          , Wo          , Wo          , Ww          , Wwf         , Wwf         , Hh          , Hh          , Ww          , Ww          , Ww          , Wwf         , Gs          , Ww          , Ww          , Wo          
Ww          , Ww          , Ww          , Ww          , Ww          , Ww          , Wo          , Ds          , Wo          , Wo          , Chw         , Chw         , Chw         , Wo          , Wo          , Wwf         , Ss          , Hh          , Ww          , Ww          , Ww          , Gs          , Gs          , Ds          , Ww          , Ww          
Ww          , Ww          , Wwr         , Wwr         , Ww          , Ww          , Ww          , Wo          , Wo          , Wo          , Chw         , 4 Khw       , Chw         , Wo          , Wo          , Wwf         , Wwf         , Hh          , Ww          , Ww          , Ss          , Gs          , Ds          , Ww^Vm       , Ww          , Ww          
Wwr         , Wwr         , Ww          , Ww          , Ww          , Ww          , Ww          , Wo          , Wo          , Wo          , Wo          , Chw         , Wo          , Wo          , Wo          , Wo          , Ww          , Ww          , Ww          , Wo          , Ss          , Gs          , Gs          , Ss          , Wo          , Wo          
Wwr         , Wwr         , Wo          , Ww          , Wo          , Ww          , Wo          , Wo          , Wo          , Wo          , Wo          , Wo          , Wo          , Wo          , Wo          , Wo          , Wo          , Ww          , Wo          , Wo          , Wo          , Ss          , Wo          , Wo          , Wo          , Wo          
