border_size=1
usage=map

Wo          , Wo          , Wo          , Wo          , Wo          , Wwf         , Ww          , Ww^Vm       , Ss          , Gs^Ft       , Gs          , Gs^Ft       , Gs          , Gs          , Gs^Ft       , Gs^Ft       , Gs          , Gs          , Gs          , Gs          , Gs          , Xu          , Uu          , Uu          , Ur          , Ur          , Uu          , Xu          , Uu          , Uu          , Ur          , Uu          , Xu          , Xu          , Uu          
Wo          , Wo          , Wo          , Wo          , Wo          , Ww          , Ww          , Ss          , Gs^Ft       , Gs          , Gs^Ft       , Gs          , Gs^Ft       , Gs          , Gs^Ft       , Gs^Ft       , Gs^Ft       , Gs^Ft       , Gs          , Gs          , Gs          , Xu          , Xu          , Uu          , Ur          , Ur          , Uu          , Xu          , Xu          , Uu          , Uu^Vu       , Uu          , Xu          , Xu          , Xu          
Wo          , Wo          , Wo          , Wo          , Ww          , Ww          , Gs^Ft       , Gs^Ft       , Gs^Ft       , Gs^Ft       , Gs^Ft       , Gs^Ft       , Ss          , Gs^Ft       , Ww^Vm       , Gs          , Ww          , Gs          , Ss          , Gs          , Ss          , Xu          , Uu          , Uu          , Wwf         , Uu          , Uu          , Uu^Vu       , Uu          , Xu          , Xu          , Xu          , Uu          , Uu^Vu       , Uu          
Wo          , Wo          , Wo          , Wo          , Ww          , Ww          , Ds          , Gs^Ft       , Gs^Ft       , Gs^Ft       , Ss          , Ss          , Ww          , Ww          , Ss          , Ww          , Ss          , Ww          , Ww          , Ss^Vm       , Ss          , Gs          , Ww          , Ww          , Ur          , Ww          , Ww          , Ww          , Ww          , Xu          , Xu          , Uu          , Cud         , Cud         , Cud         
Wo          , Wo          , Wo          , Wo          , Ww          , Wwf         , Gs          , Ss          , Ww          , Ss          , Ww          , Gs          , Ww          , Ww          , Gs          , Ss          , Gs          , Ss          , Gs^Ft       , Ww          , Ww          , Ww          , Gs          , Xu          , Uu          , Ur          , Ww          , Ww          , Wwf         , Uu          , Xu          , Uu          , Ur          , 3 Kud       , Cud         
Wo          , Wo          , Ww          , Ww          , Ww          , Wwf         , Ww          , Ww          , Gs          , Ww          , Ss          , Ww          , Gs^Ft       , Gs^Ft       , Gs          , Gs          , Gs^Ft       , Gs^Ft       , Gs^Ft       , Gs          , Gs          , Gs          , Gs          , Xu          , Uu          , Ur          , Ur          , Wwf         , Ur          , Cud         , Ur          , Ur          , Uu          , Cud         , Xu          
Xu          , Xu          , Wo          , Ww          , Ww          , Ds          , Ds          , Gs          , Gs^Ft       , Ss          , Gs          , Gs^Ft       , Gs^Ft       , Gs^Ft       , Ss          , Chr         , 2 Khs       , Chr         , Ss          , Gs^Ft       , Gs^Ft       , Gs          , Ss          , Xu          , Xu          , Uu^Vu       , Xu          , Ur          , Xu          , Cud         , Ur          , Ur          , Ur          , Xu          , Xu          
Wo          , Xu          , Wo          , Wo          , Ww          , Wwf         , Ww^Vm       , Gs          , Gs^Ft       , Gs^Ft       , Gs^Ft       , Gs^Ft       , Gs^Ft       , Gs^Ft       , Gs^Ft       , Chr         , Ch          , Ch          , Gs^Ft       , Gs^Ft       , Gs          , Gs^Ft       , Gs          , Ss          , Gs          , Xu          , Cud         , Xu          , Uu^Vu       , Ur          , Ur          , Ur          , Cud         , Xu          , Xu          
Wo          , Ww^Vm       , Wo          , Wo          , Ww          , Wwf         , Ds          , Gs^Ft       , Ds          , Gs^Ft       , Gs          , Gs^Ft       , Gs          , Gs          , Gs^Ft       , Gs          , Gs^Ft       , Gs^Ft       , Gs^Ft       , Gs          , Gs^Ft       , Gs          , Gs^Ft       , Gs^Ft       , Xu          , Xu          , Cud         , Cud         , Cud         , Ur          , Xu          , Cud         , Ur          , Xu          , Xu          
Wo          , Wo          , Wo          , Ww          , Ww          , Wwf         , Ww          , Ds          , Ds          , Ds          , Gs          , Gs          , Gs^Ft       , Gs          , Gs^Ft       , Gs          , Gs^Ft       , Gs^Ft       , Gs          , Gs          , Gs^Ft       , Gs^Ft       , Gs^Ft       , Gs^Ft       , Xu          , Cud         , Kud         , Cud         , Xu          , Xu          , Uu          , Ur          , Uu          , Uu^Vu       , Uu          
Wo          , Wo          , Wo          , Wo          , Wo          , Ww          , Wo          , Chs         , 1 Khs       , Ds          , Ds          , Gs          , Gs^Ft       , Gs^Ft       , Gs^Ft       , Gs^Ft       , Gs          , Gs          , Gs          , Gs          , Gs^Ft       , Gs          , Gs          , Gs          , Gs          , Xu          , Xu          , Xu          , Uu^Vu       , Xu          , Ur          , Ur          , Ur          , Uu          , Ur          
Wo          , Wo          , Wo          , Wo          , Wo          , Ww          , Chw         , Chw         , Chw         , Chs         , Ds          , Gs^Ft       , Gs          , Gs^Ft       , Ss          , Ss          , Ss^Vm       , Gs^Ft       , Gs^Ft       , Gs          , Gs          , Gs          , Ww          , Ww^Vm       , Ww          , Gs          , Xu          , Uu          , Ur          , Xu          , Ww          , Ww          , Ww          , Ur          , Ur          
Wo          , Wo          , Wo          , Wo          , Wo          , Ww          , Ww          , Chw         , Wwf         , Ds          , Ds          , Gs          , Gs          , Gs          , Ss          , Ss          , Ww          , Gs^Ft       , Gs^Ft       , Gs^Ft       , Ww          , Ww          , Ww          , Ww          , Gs^Ft       , Ww          , Ww          , Ur          , Ur          , Ww          , Ww          , Ww          , Wwf         , Uu          , Ur          
Wo          , Wo          , Wo          , Wo          , Wo          , Wo          , Ww          , Ww          , Ww          , Wwf         , Ww          , Ds          , Ww          , Ss          , Wwf         , Ww          , Ww          , Ww          , Wwf         , Ww          , Wwf         , Ww          , Gs^Ft       , Xu          , Xu          , Xu          , Uu          , Wwf         , Ww          , Ww          , Uu          , Uu          , Uu          , Uu          , Uu          
Wo          , Wo          , Wo          , Wo          , Wo          , Wo          , Wo          , Ww          , Ww          , Wwf         , Ww          , Ww          , Ww          , Ww          , Wwf         , Ww          , Gs^Ft       , Wwf         , Ww          , Wwf         , Ss          , Ss^Vm       , Ss          , Xu          , Uu          , Uu^Vu       , Ur          , Ur          , Ur          , Ww          , Uu          , Uu          , Xu          , Uu^Vu       , Uu          
Wo          , Wo          , Wo          , Wo          , Wo          , Wo          , Wo          , Ww          , Ww          , Ww          , Ww          , Ww          , Ww          , Ww          , Ww          , Gs          , Gs^Ft       , Gs^Ft       , Gs^Ft       , Gs^Ft       , Gs^Ft       , Gs^Ft       , Gs^Ft       , Xu          , Ur          , Ur          , Uu          , Xu          , Xu          , Ur          , Ur          , Xu          , Xu          , Uu          , Uu          
Wo          , Wo          , Wo          , Wo          , Wo          , Wo          , Wo          , Ww          , Ww          , Ww          , Ww          , Ww          , Ww          , Ww          , Ds          , Ds          , Gs^Ft       , Gs^Ft       , Gs^Ft       , Gs          , Gs          , Gs          , Gs          , Xu          , Xu          , Uu          , Xu          , Xu          , Ds          , Xu          , Uu^Vu       , Uu^Vu       , Xu          , Xu          , Xu          
Wo          , Wo          , Wo          , Wo          , Wo          , Xu          , Xu          , Wo          , Wo          , Ww          , Ww          , Ww          , Wwf         , Wwf         , Ds          , Gs          , Gs          , Gs^Ft       , Gs          , Gs          , Ds          , Gs          , Ss          , Ss          , Ss          , Xu          , Gs^Ft       , Ds          , Ds          , Xu          , Xu          , Xu          , Xu          , Ww^Vm       , Xu          
Wo          , Wo          , Wo          , Wo          , Wo          , Xu          , Wo          , Wo          , Wo          , Ww          , Ww          , Ww          , Wwf         , Wwf         , Ww          , Ds          , Ds          , Ds          , Ds          , Ds          , Ds          , Gs          , Gs^Ft       , Ss          , Gs^Ft       , Gs^Ft       , Ds          , Ds          , Ds          , Ds          , Ds          , Ds          , Ww          , Wwf         , Wwf         
Wo          , Wo          , Wo          , Wo          , Wo          , Wo          , Wo          , Wo          , Wo          , Wo          , Wo          , Wo          , Wo          , Wwf         , Wwf         , Ww          , Ww          , Ww^Vm       , Ww          , Ds          , Ds          , Ss^Vm       , Ss          , Gs^Ft       , Gs^Ft       , Gs^Ft       , Ds          , Ds          , Ww          , Wwf         , Ww^Vm       , Wo          , Wo          , Wo          , Wo          
Wo          , Wo          , Wo          , Wo          , Wo          , Wo          , Wo          , Wo          , Wo          , Wo          , Wo          , Xu          , Xu          , Wo          , Wo          , Wo          , Wo          , Wo          , Wo          , Ww          , Ww          , Ss          , Ds          , Ds          , Ds          , Ds          , Ww          , Ds          , Ww          , Ww          , Wo          , Wo          , Wo          , Wo          , Wo          
